###################
#@     BB         #
#  *** BB         #
#      BB        .#
###################