##########
#   F    # 
#  *F   .#
#     FFF#
#@       #
##########