##########
#        #  
#@   *   #
#   ######
#       .#
##########