###############
#@       #.   #
#      * ###  #
#  #########  #
#             #
###########   #
          #####