##########
#        #  
#@*F* BB.#
#   B#####
#       .#
##########
