---------------
-- @ -----.----
--  *----- ----
--   ----- ----
--         ----
---------  ----
---------------